0000000000000000000011000
0000000000000000011110000
0000000000000011110000000
0000000000000110000000000
0000000000001100000000011
0000000000001000000011110
0000000000001000000110000
0000000000001000000100000
0000000000001000000100000
0000000000001000000100000
0000000000001000001100000
0000000000001000001000000
0000000000001000001000000
1000000000001000001000000
1111111100001000011000000
0000000110011000010000000
0000000011110000100000000
0111100010000111100000000
0000110010001100000000000
0000010000001000000000000
1110110000010000000000000
0010100111110000000000000
0010101100000000000000000
0010100000000000000000000
0000100000000000000000000