0000000000000000000001000
0000000000000000000011000
0000000000000011111110000
0000000000000100000000000
0000000000000100000000111
0000000000001100001111100
0000000000001000011000000
0000000000001000110000000
0000000000001000100000000
0000000000001001100000000
0000000000001001000000000
0000000000001001000000000
0000000000001001000000000
0000000000001001000000000
0000000000001001000000000
0000000000001001000000000
0000000000001001100000000
0000000000001000100000000
0000000000001000100000000
0000000000001100100000000
0000000000000100100000000
1111111111111100100000000
1000000000000000100000000
0001111111111111100000000
0001000000000000000000000